XXXXXXXXXXXXXXXXXXXXXXXXXXXXXXXXXXXXXXXXXXXXXXXXXXXXXXXXXXXX
X                                                          X
X                                                          X
X                                                          X
X                                                          X
X                                                          X
X        @                                        H        X
X        @                                        H        X
X        @                                        H        X
X        @                                        H        X
X        @                                        H        X
X        @                                        H        X
X        @                                        H        X
X        @                                        H        X
X                                                          X
X                                                          X
X                                                          X
X                                                          X
X                                                          X
XXXXXXXXXXXXXXXXXXXXXXXXXXXXXXXXXXXXXXXXXXXXXXXXXXXXXXXXXXXX