XXXXXXXXXXXXXXXXXXXXXXXXXXXXXXXXXXXXXXXXXXXXXXXXXXXXXXXXXXXX
X X            X     X                        X        &   X
X X       &    X     :       -  ...     -     :            X
X X            X &   X           ...    -     X            X
X :            :     X    -     ...     -     X            X
X X            XXXXXXX    -    ...            X   &        X
X X            X     X    -   ...  -    &     XXXXXXXXX    X
X X            X     X                        X    @  X    X
X X            XXXX XXXXXXXXXXXXXXXXXXXXXXXXXXX @     X    X
X X                                  A                X    X
X X                                  A                X    X
X XXXXXXXXXXXXXXXXXXXXXXX:XXXXXXXXXXXXXXXXXXXXX       X    X
X X                                           X  @    X    X
X X         XXX:XXX:XXX:XXX:XXX:XXX:XXX:XXX:X X       X    X
X X         X   X   X   X   X&  X   X   X & X XXXXXXXXXXX:XX
X X         X   X   X & X   X   X   X   X& &X X      :     X
X X         XXXXXXXXXXXXXXXXXXXXXXXXXXXXXXXXX X  XX  X  &  X
X X:XXXXXXXXX   X   X   X   X   &      -         XX  X     X
X     &       X   X   X   X            -             :     X
XXXXXXXXXXXXXXXXXXXXXXXXXXXXXXXXXXXXXXXXXXXXXXXXXXXXXXXXXXXX