                                         ..~~~~..           
                             O           ..~~~~..           
       O                                 ..~~~~...          
   O       O               O  O           ..~~~~..          
                                          ..~~~~...         
      O                                    ..~~~~..         
           O        O                      ..~~~~...        
                               O           ...~~~~..        
        O                                   ..~~~~..        
                         XXXXXXX            ..~~~~..        
                         X+++++X           ..~~~~..         
   G G G                "X+++++#           ..~~~~..         
                        "X+++++#          ...~~~~..         
   G G G                "X+++++X          ...~~~~..         
                    XX+XXX+++++X      O   ..~~~~..          
                    X++++X+++++#          ..~~~~..          
                    #++++++++++#         ...~~~~..          
          O         X++++X+++++X         ..~~~~..      O    
                    XXXXXXXXX+XX        ...~~~~.            
                                        ...~~~~.            